20
19
###################
#                 #
# $$$$$$$$$$$$$$$ #
# $             $ #
# $ $$$$$$$$$$$ $ #
#   $         $   #
#   $ $$$$$$$ $   #
#     $     $     #
#     $ $$$ $     #
#       $@$       #
#       $ $       #
#                 #
#                 #
#                 #
#        $        #
#                 #
#                 #
#                 #
#                 #
###################